{
    "Clear map" : {
        "map" : [
            [0,0,0,0,0,0,0,0,0,0,0,0,0,0,0,0,0,0,0,0],
            [0,0,0,0,0,0,0,0,0,0,0,0,0,0,0,0,0,0,0,0],
            [0,0,0,0,0,0,0,0,0,0,0,0,0,0,0,0,0,0,0,0],
            [0,0,0,0,0,0,0,0,0,0,0,0,0,0,0,0,0,0,0,0],
            [0,0,0,0,0,0,0,0,0,0,0,0,0,0,0,0,0,0,0,0],
            [0,0,0,0,0,0,0,0,0,0,0,0,0,0,0,0,0,0,0,0],
            [0,0,0,0,0,0,0,0,0,0,0,0,0,0,0,0,0,0,0,0],
            [0,0,0,0,0,0,0,0,0,0,0,0,0,0,0,0,0,0,0,0],
            [0,0,0,0,0,0,0,0,0,0,0,0,0,0,0,0,0,0,0,0],
            [0,0,0,0,0,0,0,0,0,0,0,0,0,0,0,0,0,0,0,0],
            [0,0,0,0,0,0,0,0,0,0,0,0,0,0,0,0,0,0,0,0],
            [0,0,0,0,0,0,0,0,0,0,0,0,0,0,0,0,0,0,0,0],
            [0,0,0,0,0,0,0,0,0,0,0,0,0,0,0,0,0,0,0,0],
            [0,0,0,0,0,0,0,0,0,0,0,0,0,0,0,0,0,0,0,0],
            [0,0,0,0,0,0,0,0,0,0,0,0,0,0,0,0,0,0,0,0],
            [0,0,0,0,0,0,0,0,0,0,0,0,0,0,0,0,0,0,0,0],
            [0,0,0,0,0,0,0,0,0,0,0,0,0,0,0,0,0,0,0,0],
            [0,0,0,0,0,0,0,0,0,0,0,0,0,0,0,0,0,0,0,0],
            [0,0,0,0,0,0,0,0,0,0,0,0,0,0,0,0,0,0,0,0],
            [0,0,0,0,0,0,0,0,0,0,0,0,0,0,0,0,0,0,0,0]
        ],

        "start_position" : [5,5],
        
        "record" : 0

    },

    "Borderlined" : {
        "map" : [
            [1,1,1,1,1,1,0,0,0,0,0,0,0,0,1,1,1,1,1,1],
            [1,0,0,0,0,0,0,0,0,0,0,0,0,0,0,0,0,0,0,1],
            [1,0,0,0,0,0,0,0,0,0,0,0,0,0,0,0,0,0,0,1],
            [1,0,0,0,0,0,0,0,0,0,0,0,0,0,0,0,0,0,0,1],
            [1,0,0,0,0,0,0,0,0,0,0,0,0,0,0,0,0,0,0,1],
            [1,0,0,0,0,0,0,0,0,0,0,0,0,0,0,0,0,0,0,1],
            [0,0,0,0,0,0,0,0,0,0,0,0,0,0,0,0,0,0,0,0],
            [0,0,0,0,0,0,0,0,0,0,0,0,0,0,0,0,0,0,0,0],
            [0,0,0,0,0,0,0,0,0,0,0,0,0,0,0,0,0,0,0,0],
            [0,0,0,0,0,0,0,0,0,0,0,0,0,0,0,0,0,0,0,0],
            [0,0,0,0,0,0,0,0,0,0,0,0,0,0,0,0,0,0,0,0],
            [0,0,0,0,0,0,0,0,0,0,0,0,0,0,0,0,0,0,0,0],
            [0,0,0,0,0,0,0,0,0,0,0,0,0,0,0,0,0,0,0,0],
            [0,0,0,0,0,0,0,0,0,0,0,0,0,0,0,0,0,0,0,0],
            [1,0,0,0,0,0,0,0,0,0,0,0,0,0,0,0,0,0,0,1],
            [1,0,0,0,0,0,0,0,0,0,0,0,0,0,0,0,0,0,0,1],
            [1,0,0,0,0,0,0,0,0,0,0,0,0,0,0,0,0,0,0,1],
            [1,0,0,0,0,0,0,0,0,0,0,0,0,0,0,0,0,0,0,1],
            [1,0,0,0,0,0,0,0,0,0,0,0,0,0,0,0,0,0,0,1],
            [1,1,1,1,1,1,0,0,0,0,0,0,0,0,1,1,1,1,1,1]
        ],

        "start_position" : [5,5],
        
        "record" : 0

    },

    "kasztan" : {
        "map" : [
            [1,1,1,1,1,1,0,0,0,0,0,0,0,0,1,1,1,1,1,1],
            [1,0,0,0,0,0,0,0,0,0,0,0,0,0,0,0,0,0,0,1],
            [1,0,0,0,0,0,0,0,0,0,0,0,0,0,0,0,0,0,0,1],
            [1,0,0,0,0,0,0,0,0,0,0,0,0,0,0,0,0,0,0,1],
            [1,0,0,0,1,0,0,0,0,0,0,0,0,0,0,1,0,0,0,1],
            [1,0,0,0,0,1,1,1,0,0,0,0,1,1,1,0,0,0,0,1],
            [0,0,0,0,0,1,0,0,0,0,0,0,0,0,1,0,0,0,0,0],
            [0,0,0,0,0,1,0,0,0,1,1,0,0,0,1,0,0,0,0,0],
            [0,0,0,0,0,0,0,0,1,1,1,1,0,0,0,0,0,0,0,0],
            [0,0,0,0,0,0,0,1,1,1,1,1,1,0,0,0,0,0,0,0],
            [0,0,0,0,0,0,0,1,1,1,1,1,1,0,0,0,0,0,0,0],
            [0,0,0,0,0,0,0,0,1,1,1,1,0,0,0,0,0,0,0,0],
            [0,0,0,0,0,1,0,0,0,1,1,0,0,0,1,0,0,0,0,0],
            [0,0,0,0,0,1,0,0,0,0,0,0,0,0,1,0,0,0,0,0],
            [1,0,0,0,0,1,1,1,0,0,0,0,1,1,1,0,0,0,0,1],
            [1,0,0,0,1,0,0,0,0,0,0,0,0,0,0,1,0,0,0,1],
            [1,0,0,0,0,0,0,0,0,0,0,0,0,0,0,0,0,0,0,1],
            [1,0,0,0,0,0,0,0,0,0,0,0,0,0,0,0,0,0,0,1],
            [1,0,0,0,0,0,0,0,0,0,0,0,0,0,0,0,0,0,0,1],
            [1,1,1,1,1,1,0,0,0,0,0,0,0,0,1,1,1,1,1,1]
        ],

        "start_position" : [5,5],
        
        "record" : 0

    },

    "mega_border" : {
        "map" : [
            [1,1,1,1,1,1,0,0,0,0,0,0,0,0,1,1,1,1,1,1],
            [1,0,0,0,0,0,0,0,0,0,0,0,0,0,0,0,0,0,0,1],
            [1,0,0,0,0,0,0,0,0,0,0,0,0,0,0,0,0,0,0,1],
            [1,0,0,0,0,0,0,0,0,0,0,0,0,0,0,0,0,0,0,1],
            [1,0,0,0,0,0,0,0,0,0,0,0,0,0,0,0,0,0,0,1],
            [1,0,0,0,0,1,1,1,0,0,0,0,1,1,1,0,0,0,0,1],
            [0,0,0,0,0,1,0,0,0,0,0,0,0,0,1,0,0,0,0,0],
            [0,0,0,0,0,1,0,0,0,0,0,0,0,0,1,0,0,0,0,0],
            [0,0,0,0,0,0,0,0,0,0,0,0,0,0,0,0,0,0,0,0],
            [0,0,0,0,0,0,0,0,0,0,0,0,0,0,0,0,0,0,0,0],
            [0,0,0,0,0,0,0,0,0,0,0,0,0,0,0,0,0,0,0,0],
            [0,0,0,0,0,0,0,0,0,0,0,0,0,0,0,0,0,0,0,0],
            [0,0,0,0,0,1,0,0,0,0,0,0,0,0,1,0,0,0,0,0],
            [0,0,0,0,0,1,0,0,0,0,0,0,0,0,1,0,0,0,0,0],
            [1,0,0,0,0,1,1,1,0,0,0,0,1,1,1,0,0,0,0,1],
            [1,0,0,0,0,0,0,0,0,0,0,0,0,0,0,0,0,0,0,1],
            [1,0,0,0,0,0,0,0,0,0,0,0,0,0,0,0,0,0,0,1],
            [1,0,0,0,0,0,0,0,0,0,0,0,0,0,0,0,0,0,0,1],
            [1,0,0,0,0,0,0,0,0,0,0,0,0,0,0,0,0,0,0,1],
            [1,1,1,1,1,1,0,0,0,0,0,0,0,0,1,1,1,1,1,1]
        ],

        "start_position" : [5,5],
        
        "record" : 0

    },

    "some_dotted_line" : {
        "map" : [
            [1,1,0,0,1,0,0,1,0,0,1,0,0,1,0,0,1,0,1,1],
            [1,0,0,0,0,0,0,0,0,0,0,0,0,0,0,0,0,0,0,1],
            [0,0,0,0,0,0,0,0,0,0,0,0,0,0,0,0,0,0,0,0],
            [1,0,0,0,0,0,0,0,0,0,0,0,0,0,0,0,0,0,0,0],
            [0,0,0,0,0,0,0,0,0,0,0,0,0,0,0,0,0,0,0,1],
            [0,0,0,0,0,0,0,0,0,0,0,0,0,0,0,0,0,0,0,0],
            [1,0,0,0,0,0,0,0,0,0,0,0,0,0,0,0,0,0,0,0],
            [0,0,0,0,0,0,0,0,0,0,0,0,0,0,0,0,0,0,0,1],
            [0,0,0,0,0,0,0,0,0,0,0,0,0,0,0,0,0,0,0,0],
            [1,0,0,0,0,0,0,0,0,0,0,0,0,0,0,0,0,0,0,0],
            [0,0,0,0,0,0,0,0,0,0,0,0,0,0,0,0,0,0,0,1],
            [0,0,0,0,0,0,0,0,0,0,0,0,0,0,0,0,0,0,0,0],
            [1,0,0,0,0,0,0,0,0,0,0,0,0,0,0,0,0,0,0,0],
            [0,0,0,0,0,0,0,0,0,0,0,0,0,0,0,0,0,0,0,1],
            [0,0,0,0,0,0,0,0,0,0,0,0,0,0,0,0,0,0,0,0],
            [1,0,0,0,0,0,0,0,0,0,0,0,0,0,0,0,0,0,0,0],
            [0,0,0,0,0,0,0,0,0,0,0,0,0,0,0,0,0,0,0,1],
            [0,0,0,0,0,0,0,0,0,0,0,0,0,0,0,0,0,0,0,0],
            [1,0,0,0,0,0,0,0,0,0,0,0,0,0,0,0,0,0,0,1],
            [1,1,0,0,1,0,0,1,0,0,1,0,0,1,0,0,1,0,1,1]
        ],

        "start_position" : [5,5],
        
        "record" : 0

    },
    "diagonalized" : {
        "map" : [
            [1,1,1,1,1,1,1,1,1,1,1,1,1,1,1,1,1,1,1,1],
            [1,1,0,0,0,0,0,0,0,0,0,0,0,0,0,0,0,0,0,1],
            [1,0,1,0,0,0,0,0,0,0,0,0,0,0,0,0,0,0,0,0],
            [1,0,0,1,0,0,0,0,0,0,0,0,0,0,0,0,0,0,0,0],
            [1,0,0,0,1,0,0,0,0,0,0,0,0,0,0,0,0,0,0,0],
            [1,0,0,0,0,1,0,0,0,0,0,0,0,0,0,0,0,0,0,1],
            [1,0,0,0,0,0,1,0,0,0,0,0,0,0,0,0,0,0,0,1],
            [1,0,0,0,0,0,0,1,0,0,0,0,0,0,0,0,0,0,0,1],
            [1,0,0,0,0,0,0,0,1,0,0,0,0,0,0,0,0,0,0,1],
            [1,0,0,0,0,0,0,0,0,1,0,0,0,0,0,0,0,0,0,1],
            [1,0,0,0,0,0,0,0,0,0,1,0,0,0,0,0,0,0,0,1],
            [1,0,0,0,0,0,0,0,0,0,0,1,0,0,0,0,0,0,0,1],
            [1,0,0,0,0,0,0,0,0,0,0,0,1,0,0,0,0,0,0,1],
            [1,0,0,0,0,0,0,0,0,0,0,0,0,1,0,0,0,0,0,1],
            [1,0,0,0,0,0,0,0,0,0,0,0,0,0,1,0,0,0,0,1],
            [0,0,0,0,0,0,0,0,0,0,0,0,0,0,0,1,0,0,0,1],
            [0,0,0,0,0,0,0,0,0,0,0,0,0,0,0,0,1,0,0,1],
            [0,0,0,0,0,0,0,0,0,0,0,0,0,0,0,0,0,1,0,1],
            [1,0,0,0,0,0,0,0,0,0,0,0,0,0,0,0,0,0,1,1],
            [1,1,1,1,1,1,1,1,1,1,1,1,1,1,1,1,1,1,1,1]
        ],

        "start_position" : [5,5],
        
        "record" : 0

    },
    "doubly diagonalized" : {
        "map" : [
            [1,1,1,1,1,1,1,1,0,0,0,0,1,1,1,1,1,1,1,1],
            [1,0,0,0,0,0,0,0,0,0,0,0,0,0,0,0,0,0,0,1],
            [1,0,1,0,0,0,0,0,0,0,0,0,0,0,0,0,0,1,0,0],
            [1,0,0,1,0,0,0,0,0,0,0,0,0,0,0,0,1,0,0,0],
            [1,0,0,0,1,0,0,0,0,0,0,0,0,0,0,1,0,0,0,0],
            [1,0,0,0,0,1,0,0,0,0,0,0,0,0,1,0,0,0,0,1],
            [1,0,0,0,0,0,1,0,0,0,0,0,0,1,0,0,0,0,0,1],
            [1,0,0,0,0,0,0,1,0,0,0,0,1,0,0,0,0,0,0,1],
            [0,0,0,0,0,0,0,0,1,0,0,1,0,0,0,0,0,0,0,0],
            [0,0,0,0,0,0,0,0,0,1,1,0,0,0,0,0,0,0,0,0],
            [0,0,0,0,0,0,0,0,0,1,1,0,0,0,0,0,0,0,0,0],
            [0,0,0,0,0,0,0,0,1,0,0,1,0,0,0,0,0,0,0,0],
            [1,0,0,0,0,0,0,1,0,0,0,0,1,0,0,0,0,0,0,1],
            [1,0,0,0,0,0,1,0,0,0,0,0,0,1,0,0,0,0,0,1],
            [1,0,0,0,0,1,0,0,0,0,0,0,0,0,1,0,0,0,0,1],
            [1,0,0,0,1,0,0,0,0,0,0,0,0,0,0,1,0,0,0,1],
            [1,0,0,1,0,0,0,0,0,0,0,0,0,0,0,0,1,0,0,1],
            [1,0,1,0,0,0,0,0,0,0,0,0,0,0,0,0,0,1,0,1],
            [1,0,0,0,0,0,0,0,0,0,0,0,0,0,0,0,0,0,0,1],
            [1,1,1,1,1,1,1,1,0,0,0,0,1,1,1,1,1,1,1,1]
        ],

        "start_position" : [5,5],
        
        "record" : 0

    }
}